All Under Heaven: Recipes from the 35 Cuisines of China
Peter Reinhart's Whole Grain Breads: New Techniques, Extraordinary Flavor
Plenty
Smoke & Pickles: Recipes and Stories from a New Southern Kitchen
Korean American: Food that Tastes Like Home
Koreatown: A Cookbook
Maangchi's Real Korean Cooking: Authentic Dishes for the Home Cook
Korean Food Made Simple
The Korean Vegan Cookbook: Reflections and Recipes from Omma's Kitchen
K Food: Korean Home Cooking and Street Food
The Kimchi Cookbook: 60 Traditional and Modern Ways to Make and Eat Kimchi
Korean Home Cooking: Classic and Modern Recipes
My Korea: Traditional Flavors, Modern Recipes
Seoul Food Korean Cookbook: Korean Cooking from Kimchi and Bibimbap to Fried Chicken and Bingsoo
Every Grain of Rice: Simple Chinese Home Cooking
Stir-Frying to the Sky's Edge: The Ultimate Guide to Mastery, with Authentic Recipes and Stories
The Food of Sichuan: A New and Updated Edition of the Classic Land of Plenty
Land of Plenty: A Treasury of Authentic Sichuan Cooking
Land of Fish and Rice: Recipes from the Culinary Heart of China
China Moon Cookbook
Beyond the Great Wall: Recipes and Travels in the Other China
China: The Cookbook
Mooncakes and Milk Bread: Sweet and Savory Recipes Inspired by Chinese Bakeries
The Vegan Chinese Kitchen: Recipes and Modern Stories from a Thousand-Year-Old Tradition
Xi'an Famous Foods: The Cuisine of Western China, from New York's Favorite Noodle Shop
Chinese-ish: Home Cooking, Not Quite Authentic, 100% Delicious
Hot Sour Salty Sweet: A Culinary Journey Through Southeast Asia
Mister Jiu's in Chinatown: Recipes and Stories from the Birthplace of Chinese American Food
BAO
Hunan: A Lifetime of Secrets from Mr Peng's Chinese Kitchen
The Wok: Recipes and Techniques
First Generation: Recipes from My Taiwanese-American Home
Phoenix Claws and Jade Trees: Essential Techniques of Authentic Chinese Cooking
Complete Chinese Cookbook
The Food of Taiwan: Recipes from the Beautiful Island
Mastering the Art of Chinese Cooking
Japanese Farm Food
Japanese Soul Cooking: Ramen, Tonkatsu, Tempura, and More from the Streets and Kitchens of Tokyo and Beyond
Mastering the Art of Japanese Home Cooking
The Japanese Grill: From Classic Yakitori to Steak, Seafood, and Vegetables
Japan: The Cookbook
Washoku: Recipes from the Japanese Home Kitchen
Tokyo Cult Recipes
Ivan Ramen: Love, Obsession, and Recipes from Tokyo's Top Noodle Joint
Donabe: Traditional and Modern Japanese Clay Pot Cooking
Japanese Pâtisserie: Exploring the Beautiful and Delicious Fusion of East meets West
Robata: Japanese Home Grilling
Japanese Home Cooking: Simple Meals, Authentic Flavors
Momofuku
The New Japanese Cookbook: From Kyoto to Tokyo Discover Delicious Japanese Cooking with Easy Japanese Recipes
Izakaya: The Japanese Pub Cookbook
Kyotofu: Uniquely Delicious Japanese Desserts
Preserving the Japanese Way: Traditions of Salting, Fermenting, and Pickling for the Modern Kitchen
Yum-Yum Bento Box: Fresh Recipes for Adorable Lunches
Japanese Cooking: A Simple Art 25th Anniversary Edition
Japanese Cooking: A Simple Art
Indian-ish: Recipes and Antics from a Modern American Family
660 Curries: Plus Biryanis, Breads, Pilafs, Raitas, and More
An Invitation to Indian Cooking
Deepa's Secrets: Mouthwatering, Slow-Carb New Indian Recipes
My Bombay Kitchen: Traditional and Modern Parsi Home Cooking
Dishoom: From Bombay with Love: Cookery Book and Highly Subjective Guide to Bombay with Map
The Indian Cookery Course: Techniques, Masterclasses, Ingredients, Traditional Recipes
Hidden Kitchens of Sri Lanka
Seven Fires: Grilling the Argentine Way
Yucatán: Recipes from a Culinary Expedition
Authentic Mexican, 20th Anniversary Edition: Regional Cooking from the Heart of Mexico
Oaxaca: Home Cooking from the Heart of Mexico
Tacos: Recipes and Provocations
Diasporican: A Puerto Rican Cookbook
Mi Cocina: Recipes and Rapture from My Kitchen in Mexico
Nopalito: A Mexican Kitchen
The Complete Mediterranean Cookbook: 500 Vibrant, Kitchen-Tested Recipes for Living and Eating Well Every Day
The Food of Spain
The Essential Cuisines of Mexico: Revised and updated
The Mexican Home Kitchen: Over 75 Traditional Home-Style Recipes That Capture the Flavors and Memories of Mexico
Nopi: The Cookbook
The Middle Eastern Vegetarian Cookbook
Taste of Persia: A Cook's Travels Through Armenia, Azerbaijan, Georgia, Iran, and Kurdistan
Plenty More
Sweet
Ottolenghi Flavour / Flavor
Ottolenghi Simple: A Cookbook
The Palestinian Table
Arabesque: A Taste of Morocco, Turkey, and Lebanon
Zaitoun: Recipes and Stories from the Palestinian Kitchen
Feast: Food of the Islamic World
Israeli Soul: Easy, Essential, Delicious
Istanbul: Recipes from the Heart of Turkey
Anatolia: Adventures in Turkish Cooking
Falastin: A Cookbook
Greece: The Cookbook
Jerusalem
My Greek Table: Authentic Flavors and Modern Home Cooking from My Kitchen to Yours
Ottolenghi: The Cookbook
Persiana: Recipes from the Middle East & Beyond
Sweet Middle East: Classic Recipes, from Baklava to Fig Ice Cream
The New Persian Kitchen
Zahav: A World of Israeli Cooking
Sababa: Fresh, Sunny Flavors from My Israeli Kitchen
Thai Food
Thai Street Food
Pok Pok: Food and Stories from the Streets, Homes, and Roadside Restaurants of Thailand
Nong's Thai Kitchen: 84 Classic Recipes That Are Quick, Healthy and Delicious
Coconut & Sambal: Recipes from My Indonesian Kitchen
The Pho Cookbook: Easy to Adventurous Recipes for Vietnam's Favorite Soup and Noodles
Into the Vietnamese Kitchen: Treasured Foodways, Modern Flavors
The Banh Mi Handbook: Recipes for Crazy-Delicious Vietnamese Sandwiches
The Slanted Door: Modern Vietnamese Food
The Country Cooking of France
Bouchon
Mastering the Art of French Cooking, Volume One
Mastering the Art of French Cooking, Volume Two
Pasta Grannies: The Secrets of Italy's Best Home Cooks
Rustic Italian Food
American Sfoglino: A Master Class in Handmade Pasta
Essentials of Classic Italian Cooking
Ethiopia: Recipes and Traditions from the Horn of Africa
The Food of Morocco
Mourad: New Moroccan: The Cookbook
Morocco: A Culinary Journey with Recipes from the Spice-Scented Markets of Marrakech to the Date-Filled Oasis of Zagora
Traditional Moroccan Cooking: Recipes from Fez
In Bibi's Kitchen: The Recipes and Stories of Grandmothers from the Eight African Countries that Touch the Indian Ocean
The Country Cooking of Ireland
Tava: Eastern European Baking and Desserts From Romania & Beyond
The Great Scandinavian Baking Book
Good to the Grain: Baking with Whole-Grain Flours
Gluten-Free Baking at Home: 102 Foolproof Recipes for Delicious Breads, Cakes, Cookies, and More
Jeni's Splendid Ice Creams at Home: More Than 100 Addictively Good Artisanal Recipes
The Art of French Pastry
Dorie's Cookies
BraveTart: Iconic American Desserts
Patisserie: Master the Art of French Pastry
French Patisserie: Master Recipes and Techniques from the Ferrandi School of Culinary Arts
Momofuku Milk Bar
The Bread Baker's Apprentice: Mastering the Art of Extraordinary Bread
BakeWise: The Hows and Whys of Successful Baking with Over 200 Magnificent Recipes
Living Bread: Tradition and Innovation in Artisan Bread Making
Bouchon Bakery
Flour Water Salt Yeast: The Fundamentals of Artisan Bread and Pizza
The Perfect Loaf: The Craft and Science of Sourdough Breads, Sweets, and More
Where Cooking Begins: Uncomplicated Recipes to Make You a Great Cook
Meat: A Kitchen Education
More Home Cooking: A Writer Returns to the Kitchen
The Cook You Want to Be: Everyday Recipes to Impress
Mastering the Art of Southern Cooking
At Home in the Whole Food Kitchen: Celebrating the Art of Eating Well
The Zuni Cafe Cookbook: A Compendium of Recipes and Cooking Lessons from San Francisco's Beloved Restaurant
The New Midwestern Table: 200 Heartland Recipes
Taste & Technique: Recipes to Elevate Your Home Cooking
Ad Hoc at Home
Vegetable Literacy: Cooking and Gardening with Twelve Families from the Edible Plant Kingdom, with Over 300 Deliciously Simple Recipes
Heritage
Cook Beautiful
Victuals: An Appalachian Journey, with Recipes
Between Harlem and Heaven: Afro-Asian-American Cooking for Big Nights, Weeknights, and Every Day
What Katie Ate: At the Weekend
Super Natural Every Day: Well-Loved Recipes from My Natural Foods Kitchen
Real Cajun: Rustic Home Cooking from Donald Link's Louisiana
Mustards Grill Napa Valley Cookbook
You Have It Made: Delicious, Healthy, Do-Ahead Meals
It's All American Food: The Best Recipes For More Than 400 New American Classics
Buttermilk Graffiti: A Chef’s Journey to Discover America’s New Melting-Pot Cuisine
Love Soup: 160 All-New Vegetarian Recipes from the Author of The Vegetarian Epicure
All About Roasting: A New Approach to a Classic Art
Ruhlman's Twenty: 20 Techniques, 100 Recipes, A Cook's Manifesto: The Ideas and Techniques That Will Make You a Better Cook
Saladish: A Crunchier, Grainier, Herbier, Heartier, Tastier Way with Vegetables
The Gift of Southern Cooking: Recipes and Revelations from Two Great Southern Cooks
V Is for Vegetables: Inspired Recipes & Techniques for Home Cooks -- From Artichokes to Zucchini
Goat: Cooking and Eating
Bar Tartine: Techniques & Recipes
Bitter: A Taste of the World's Most Dangerous Flavor, with Recipes
Whole Grains Every Day, Every Way
Foods of the Southwest Indian Nations: Traditional and Contemporary Native American Recipes
Eat a Little Better: Great Flavor, Good Health, Better World
Toast: The Cookbook
Modernist Cuisine at Home
Classic Koffmann: 50 Years a Chef
For the Table: Easy, Adaptable, Crowd-Pleasing Recipes
I Dream of Dinner (So You Don't Have To): Low-Effort, High-Reward Recipes
The Art of Fermentation: An In-Depth Exploration of Essential Concepts and Processes from Around the World
The Sioux Chef's Indigenous Kitchen
Six Seasons: A New Way with Vegetables
The Taste of Country Cooking
Home Cooking: A Writer in the Kitchen
Jubilee: Recipes from Two Centuries of African-American Cooking
Mosquito Supper Club: Cajun Recipes from a Disappearing Bayou
Milk Street: The New Rules: Recipes That Will Change the Way You Cook
The Edna Lewis Cookbook
Bludso's BBQ Cookbook: A Family Affair in Smoke and Soul
The Whole Fish Cookbook: New Ways to Cook, Eat and Think
Everyone's Table: Global Recipes for Modern Health
Salt, Fat, Acid, Heat: Mastering the Elements of Good Cooking
Binging with Babish: 100 Recipes Recreated from Your Favorite Movies and TV Shows
Joshua Weissman: An Unapologetic Cookbook
The Complete Air Fryer Cookbook: Amazingly Easy Recipes to Fry, Bake, Grill, and Roast with Your Air Fryer
Cook Real Hawai'i
The Essential New York Times Cookbook: Tenth Anniversary Edition: The Recipes of Record
The Food Lab: Better Home Cooking Through Science
Joy of Cooking (Sixth edition)
The Complete America's Test Kitchen TV Show Cookbook 2001-2021: Every Recipe from the Hit TV Show with Product Ratings and a Look Behind the Scenes Includes the 2021 Season
The Bread Bible
